Sab		Beautiful
Ahud	Beautiful
Araf	Beautiful
Arav	Peaceful
Baha	Smart
Esak	Magnificent
Hali	 Graceful, kind
Jama	Obedient
Mert	kind
Mika	Strong
Sebu	Unique graceful
Shaj	Talented
Shaz	Companion
Syen	Obedient
Zahi	Unique graceful
Zain	Nurture
Zayn	Warrior
Aabis	Intelligent
Aaraf	Pure
Abbey	Light
Abraj	Beautiful eyed
Afsan	Gift of god
Ahsan	An act of kindness
Ajmal	Pious
Ajman	Jewel
Ajmel	Beautiful
Alawi	Smart
Alfar	Skillful
Amlah	Passionate
Amtar	Charming
Amzan	Peaceful
Assad	Happier
Asbah	Dawn
Ashin	Innocent
Ayana	Emotional
Azman	Infinite
Azmik	Beautiful soul
Azwar	Beautiful face
Azyan	Adornments
Ezaan	Charming
Farib	Intelligent
Fazin	Beautiful
Gamil	Tiger man
Haian	Kind
Halis	Unique graceful
Hamad	Amazing
Hasan	To praise
Hasin	Compassionate
Hiras	Laughter
Hisan	Good looking
Ibsan	Blossom
Izhan	Dusk
Izrin	Shining
Jamil	Convivial
Jamal	Pious
Jazib	Unique
Kahul	Kind
Majdy	Obedient
Misam	Kind
Nafiz	Pious
Nahan	Unique graceful
Najad	Star
Najmu	Companion
Navaz	Obedient
Nehal	Unique
Nehan	Pious
Qabus	Unique graceful
Rafan	Obedient
Rahid	Sacrifice
Ruzmy	Kind
Tajheer	Unique
Ahmath	Companion
Zahab	Clean
Eajaz	Obedient
Oliur	Unique
Aksad	Glorious
Munseer	Destiny
Aksad	Glorious
Zahab	Pious
Jamiel	Handsome
Kedar	Powerful
Kadin	Companion
Nail	Attainer
Rida	Pious
Ridwan	Kind
Usama	Enlighten
Zahid	Pious
Harb	War
Hisham	Generous
Fihr	Stone pestle
Eisa	God is my salvation.
Afif	Chaste
Adam	Man
Alva	Sublime
Harun	Superior
Hikmat	Wisdom
Khayri	Generous
Mubin	Clear
Makeen	Strong
Rida	Satisfaction
Nizar	Little